###################################################################################################
#S..............#...##.###..............##..#....#...#.#.#.....#.#.......#....##.#..#..##.#.....#.#
#..#.##.###..##...#..##.#.###.##.#.##..###.##...##.#..##.#..#.###..#.##..##..#.#..#.##..##.#.#....#
..#....##.##.##.#..#..###....#.....#.##...##..#...#....#.##..#....#...##...#....##.#...##..#....###
..#.##..#.#..###.#.#..##..###..#....###...#.#..##....#....#....#..##..##..#..#..#.#.#....#.##...#.#
...###..###....#.#...##..#...##....#.#..#..#.#..#.#.#.#..#..#.#..#.##..###.##...##..#.#....##.#..##
##....#...#.#.#...##..#.#..#..#.#..#.#..#..#..#..#.#.###.#.##..##.#..##.#....###..#..#.##.##.#....#
.#..#...#..#.#...#..###.###..#.#....#.#....#..#...#.....##..#.#.#.##.##..##.##.##..#.#..#...##.#..#
..#.#...#..##.##.#.#.#...#.##..##..#...###.#.#..#.#....##..##.#..###.#...#.#..#.###..###....#.##..#
..##.#.##.#.#...#...........##..##...#....#...#....##..#...#....###.#..###....##.#.#....#...#..#..#
.#.#...##.##..#....##....##....#.#..#.#.###..#.#...#...##..##.#.#..###..#.#..#..#.#.##.#.##..##..##
##.#..#..##..#.#..#..#.#..###..#...#...#..#.##.#....#..##....###...##..#.#.#.###..#...##.#.#..#...#
....#...#..#.#....#.##..##..#....###.#.#.#..#...#..#..#.##.#.#.#.#..#..##.###..#.##..##..##..#..#.#
.#.#.#....###...#.##.###...###..#.#..##.##.#...#....#.##....##..#.#.###..#.##.#..#.#.#...#.#..#..##
#...###..#.#..#..##.#.#.#.##.#.##.###...#.#..#.#..##...#.#.#...#...###.###..#..##.#..###.#..#.##.##
...#..##.#....#.#..#..#..###.....#.###....#...#.#....#....#..#.##..#.##.#.##..#..#..##..##..#..#..#
##..#..#.#..##..#.#...##....#..##.##..#..#.#....#..#.#.###...###..#..#.#.#.#....#...###...###.#..##
..###.#..#...##.#.#.#..#..##..##...#.#..#...#...#..##.#.#..###....##..#...#....#...#....###.#....##
.#..##.#...#.#...###..#..#.#.##.#....##..#.#.###...#..#..#...#.#.##..#..#.###.##.#....##.#..#..##.#
###....#.#...##..#..###...#...##...##...#..##...#...#..##.###..#.##.#..#...#....#.#....#.#.##..#.##
##....##....#.##.#..#....##.#.##.#.#....###....###.#...#.##.##..#.#.#.#...#..#...###..#.##..#..#.#.
....###.#.###.##..#.##.#.#.##....#..#.###..#...###..##..#.#..#.##..#.#..##.##..#...#.#..#.#.#..#.##
..###....#....#..#...##...###...#.#..##..#.###...#...#.#....#.##.#.#.##.#.#.#.###..#.###..###...##.
.#..#.#.#.###..##....##.##....#.#....#.###.#.##....#....###.#...#.##..##.###..#.#..###...#..##.#.##
...#..#.#..#.#.###...##.##....#.###..#.#.#...##..##.##..##.#...#....#..#....###...###..#..#..#.##.#
.#.#.###..#..#..#.#...##.#.##.#..#.#....#.#.#..#.#....#..###.#.###..###..#.##..##.#..##...##..#.##.
##....##....##.#.#..##...#..#.#.##..#....#.#..##..#.#.#.#...#.##....##.#...##.###..#.#....##....#.#
..##.#..#..#.#.###..###..#..#...##...###..#.#..#...#.##.#..#..#...###...#..#.###.##.#.#...##.###..#
..#...#.#.#...##.#....##...#...##.#.#.#..##..#...###...##.#....###..###....###.##...#..##.#.#..#..#
.#.#..#..#...###...#...#.##.##....##.#.##.##.##.###..#..##..#.##....#.##.###..#.##.#....###.##..##.
.##.##....#..###.#.#..#.#..##.##.#.#.#....#.#.###...##.#.#...##.#..##...##....#.#.#.#.#.#...#.#..##
..#.#.#.##.#.###....###.###.#..#..#..##.##..#.#.##.#.#.#.#....##....#.#..##.#....#..#..#.###...###.
###.#.##....#...#.#.#.#.##.##....#.#..#.#..##...#..##....##.###..##....##.#.#..###..#....#.##..#.##
#.#..##..##.#..##....##..##....#....#..#....#.#....###.##.#..#....#.#..##.#.#..###.#..##.#.###.##.#
##..###.##.#...##..###....#.#.#.#...##.#.##.#...#.##..#.##.#.##..###...#.##..#..#...##...##..#.##..
.#....#.#..#....###...#.#...#.#...###.#..###.#...###.##...##....#..###.#...###.##..#...#....#..#.##
..##..#..##..#.##.##.##.#.#.#.#..#....##.##.###...#...#..##.###.#..##.#...##..#.#...##.#.#..#.#.##.
#.#.##.#.#..###..#...#.###.#.#..##.#.#.###.#.##.#..##..#.#....##..##.#.###.##...##.##.#..#....#.#..
##..#.###.###....###..#.#.###...#..#..#....#..#.##.###.###.#..#....###.#.##....#..#.##.##..##..#.#.
...#..##.#.#.###..#.##..#.##..#....###..#.#....#.##.#..#..#.##..##.#..#..#.##.#....#..###.#..##..##
..#.#.#..##....###..##.#...#..##....#..##.##..##..###.#..#..###..#.##..#..#....###...##.##.#..#.#.#
.#..##..#.#.#...#.#..###.#.#..#..###.#.#.#....#...##.#.#.#..#..#..#....#...##.#.#..#..#.#....#.#..#
.#.#.##.###.###....#.##...###....##....#....###...###.#...##....#...#..###...#..##.##.##..#...#.##.
.#.##.###.#.#..#.#....#....#..##...#.##.#...#.#.##...##.#..###....#..#.###..#....###.#..##...#..#.#
###...#....#.##.#..###..#.###...##..##...##.#.#...#..##...##..#.#....##.#..#.#..#..##.#..#..#..##.#
##...#..#...#.##.##.#..##.##...#.##..##.#.#.#.##.#.#.#....#.#..##..#..##.#..#.#..##....##.##...#.#.
.##.###.#....##.#....##.#.#.#..#...#...#.##...##..##.#.##.#..###.##..###.#...###....###.##...##.#.#
...##..#.#.#.#..##..#....###.###.#.#.#.......###..#....##..#.##.#..##..##....#....###....##....##.#
.#..##..#.#...##.#.#....##.#.##...#.##.###..#.#.#....#.##.#..#.#...##.#..#.#.#..#.##.#..#.#...###.#
#.#..#.##.#...##..#.#.##...#.###..##.#.##.#...###..#.#.#....##.#..#.##..###....#...#.###.#.#...###.
##...##.##...#.###....#.#...#..#.#..#..#.###.##..#...#.#.#.##.#.###.##...#..#.###..##...#.#....##.#
..#.###.#.#.#.#..###.#..###.#.###..#.###..#......##.#.##.#..#.#..##.#.#...#.###.#..##.#.#.###...##.
..#.#...###..#.#.#..#.###..#....##....##...###..#..#.#...##...#..#.#.##.#..##..##.#..#....#..#.##.#
##.##....#..#....###..#.#..##.#.#.###.#.###.#..###.#...#....#..##...#..##.#..#.#.#...###...#...#..#
#..###.##...#.##.###.##..##..#.#.#....##.###....###.#.#.##.#..#..##.#..#.#.#....#.###....##.#..##.#
###...#...#..##.#.##..#..#...###..#.#..###.#...##.##.###.##..#..##...###..#.##....##..#...###.#.#.#
.###.#..#.#.#..#..#.###.##..#..#.##..###..###....#.#.#.###.#.###.#..#.##.#..#..#..#...##..#..###.##
.#.#..##..###..#.###..#..#.#...##.#.#.##..#...#.##..##.#...##...#.#.#..#.##.#...#.##..#.###...#.#.#
.#..#...###.###.##..#....#.#..#.###..##....#.#...##.#..#.##.##..#...#.#.#.##...##.#..##.##...###..#
..#.#.##.#.#....#.#.##..#...###.###..#.#..###..#.#..#....##.##..##.###.#..#..###...##.#.#.#..#.#.#.
..##...#.#.#..#.#.##..#.#.#.##..##..#.#...#..#...##...###.#..#.###...#..###.##.#.#...#...#.##.##..#
.#.#.#.###..#.###..###.#.#..#....#.###.#..#.###...#....#...#.#.#..###.#.#.#..#..###..#..#..#...##.#
##..##..##...##.##..#.##...#.#.###.#.#..#..###.#..##.#.##.##.#.#...#...#.###.#..###.#....##.##....#
.#..#...##..#.###..#.###...###...#....#.##..#.#..#..#.##...##...#..#..#....#.#.#..##..##..##..#..##
.#.##..#.#..#....###..##..##.#..##.#.#.###.#.#..#.#..#.##.#..#..#.#.#....###.##.#..###.#..#....#..#
##.###.#..##.##..#.##.#..###.#...#..###..###.#.##..#...##.##..#.##.#.#..#..#.###..#..#.#..###..###.
##..#.#..#....#.#..##.#..#.#.###.###..##.##....##.#...###..##.#..#.#...##.###.##..#.##.###..#.##.##
.#.#.#.##..#.#..#.#....#..#...##.#.#.##..#...#..#.##.#...##...#.##.#...#.#..###..##...###...#....##
.#.###..#.##.#..#..#.#.###....#.#..#.##....#.#.###...###..#....###....###..###.#.#.#...##.#.##..#..
#.###.##.#..#.##.###.#..#.#...#.#..#.#.#....#..#...#.##.###..#.#.###....#..#....#.#.##..###.#.#..##
##.#..#.#.#.#.#.#.###....#..###.#.#.##..###..#...#...#.#.#...#.#..###.#...##..###..###.##...#..#..#
#..###..#.#.#..##...##.#....#..#.##.#.#.##.#....###.#.#..#..#..#.###.#.##..#..#.##..#.##.#.#...#.##
###..#.###..##..#...##..#...###..###..#.##.##....#.#...###..#..##.#.#....#.##....##....##...##...##
.#..#..##..##.#.#.#..###....#.#.#.#..##...###...##..#.##.#...#..#..#.##..#...#..#..###.###..#.##.#.
#..##..#.##..#.###..#.#.#.#..##..#.#.###.#.###...##..##.#.##...###....##..##.#..###..#..###....#..#
.#...#.#..#.#.#....###.###..#.##..#..#.##.#....#.#.#.##..##.#...#...###..#.##....##.#..###.#.##.#.#
##.#..#..#....###..#.##.###.##.###..#...#....##..#.##....#..#.#.###.#..###.#..#.###..##.###..###.#.
#..#.##..##.#.###..#.###.#.#..#...#..##...#.##.#.#....###..#...#..#.#.##.###..#...###..##..#...#..#
#.##...#..#.#.#...###...#..###.#..#..#.#...###.#.#.###.###....#..##.#..#.##..#.###.###..#.#.#.#..##
#...##..#.#.#.##.#.#..#...#..#.##.#....#.###..###.#...##..#.##..###...#.#.##....#...#.##.##.#..###.
.#.#.###..#..##..#..##.#..#.#...#..#.#.#....##...#.#...#..#..#.##.##..##.#....#.#..#.#.#...##..#.##
..#..#..#.##.#..###....#..#.#..###.#....###..#.##..#.#.##....##...#...###....#.#.#..##..##....#.#.#
.#.#..#.#..##..#..#....#.##...##..###..###..#.#...#..##.#.#....##..#....#.##..#.##.#..#.#.###...##.
#.##.#.#...#...##.#..#..#.#.##.#..#.#...###...##.#...#..#...###..##.#..#.###..#.#..#...#..###.##.#.
#..#.##..#...#..#..#..###..#.###.###.#....#.##.#..###.#.#...#...#..#.##.###.#..#.###..#..#....#.#.#
.#...##.##..#.###.##.##.#..#...##..#..#.......#...#.###.##...#.#..###....##.##..#.#.#.###...##...##
##..##..#.#.#....#.#.##.#..#...##.#..#.###..#..#.##.###...##..#.###.#.#.###..#.#.##..#..#....#....#
.#...#.#..#.##...#..#.#.#.##.###.##.#....#.###..###..#.###..#.###...#.##....###.#.#..###..##.###..#
#.##..##...#.#..#.##.###..#.#..#.###..#.##...#.#..#...##..#..##..###.#.#.###.#.###.#....###.#..##.#
.#..#.#.#....#..#....#..#..#.##...##.#..#.#..#....##.###.#..#..##..##..#.##..#....#..#..##...#.#.#.
##.#.##.##..##...#.#.#..##.#.#..###.##...#....###.#.#....#.#...#..#.#.#....###.#..#..##.#.#...##..#
#.###...###.#..##..#.#.###..#...##.###....#..#.#..###.#.#..#.##.##..#..##....##....#.#..###..###.#.
..##.#.#.##...###...#.##.#...###.##.##.#..##.###..#.###.#..#..#.#.#...#.##.###.#..##..###..##...#.#
#.###.#.#..#...#...##..#..###.#.#.#...##.##..#.#.#..#...#.#.#.##...##..#....##.###.#.#.#.#..#.###.#
.#..#.###.##.###...##..#..#.###.#..#.###...#....#.#..##.#.#.###..#..###.#..#.#.#.##....###..##.##.#
.#..##..#..##..#.###..#..#...###.#.#..##...##.###.#.#.#..#.##.#....#.###.###.#.##.##...#.#.#.###..#
##.#..###.#.#..###...###..#.#.###..#....###.#..##.#.#.#..##..##...#.##.#.###..#.##...#.##.#..#...##
.#..##..#.#.#..##.##..#...#.#.#...##.#..#.#...###...#...###.###.##.#..###...#.#...###..#.##.#..#.#.
.#..#.#.#.#..#...#.###.#.#.###.##.#.###.#.#.##.#....#.#.#..#.#.#.##....#.#..#...###.###.#.###.#..##
#.###.#..#.##..#.#.#.#.###...#.##.#.#..#.##....##.#..#..#.##.#..#.#...#.#.##.##..#..#..##.#..###..#
.#.#...#.###..#....##..#.#.###.#..###.#..###.##...#.###....#..##.#..##...###..###.#.#...##.##...##.
..#..#..#..#..#..##.#.#..#.#..##..###.#..#.#..#.#.#.##..#.#..###...###.#..##..#....##..##...##.#..#
.#..##.#.#.#.#.#.#..###.#..#.#...#.#..###.#..#...#.#.#.#..#.##.#.#..#.###..##..#.##.#.#.##.#.#.#..#
.#.###.#..#...##..#.##..#.###..#.##.###.#.#.##.#.##.#..#.##.#..#..##.###..#.#.###...#.#..#.#.#.#..#
.#..##..#.#..#.#.#..##..##...#..#...#..#.##.#.#..#...##.#..##.#.###.#.###.###.#.##...###.#...#..##.
#..#....#.#..#....#..###.#.#...#...#.#.#..#...#..##..###.#..###...#....#.##..#..#..##.#.#..##..###.
#..#..#..##.##..#...#.##..##...##..#.#.#..###..#....###.##..#....#..##.#.###.#..#..###...###..##..#
#..#.#...#.##...#.##...#..#...##...###.#.#.###..#..##...#...#.##...###..#.#.###..#..###.#..#.##...#
#..#....##...###.#.##....#.##.#..###.#.#.#.##..#.##.##..#.##..###.##..#....#...#.##.#.#..#.#..###.#
#..#.#..#...##...###..##.#.##.#..##.#.#..#..#.##.#.##...#...#.##...#.#.###.#..##..##..#.##.#..#.#.#
##.#.##...##.#.##.##.#..#.###.###..##..##.##..#.##.#..#.##..#...#.##.#..#...##.#..##.#.##.#.###.#.#
#.###.##...##.##.##.#.#..#..###.###..#.#.#.#....##..#..##..#..#..#.##..###..###.###..#.#..##..##.##
##..#.#...#..###.##..#.##..#.#..#...###.#.##.#...###.###.###.##...##.#.#.###.##.###..#.###..#.##.##
#.#.#..###.###..###...#.###..#.#.##.###.#.#.#.#.#..###.###..#....#.#...##.##.#...#...#.###.#..#.##.
#..#..###...##..#.#..#.##.#.#..#..#.###.###.#.#.#..#.###.#.###..###.#.##.#.#.#.#.#...#.###.#.#...##
#...#.##..#..#.#..##..#....##.#...#...##.###..#...#..#.#...##.##..#.###.#.##.###..##...#....#....#.
#.#.##.#.#.###..#.#...###...#.##..#.#...##.##.###..##.#.#.###.#..#.#..#.#...#.##..##..#.#..#.###..#
#.#.#.#..#...#.#.##.###..##..#.###..###..#..#.###..#....#..##.#..###..#.###.#.#..#.###.##.#..#.#..#
#.###.##.###.##..###..#.#.#..#.##..###.#.##..##.#..#...##..###..##...#..##.##.#...#..###.#...#.#.#.
##.#.#..#.#.###..###..##..###.#.#.#...#....##..##.###...#.##.#..#.#.#..###.#..#.##.#.###.#.#.#.#.#.
#.#..#..#.##...###..#.###.##..#.#.###.#.#.##.#.#...#..###.#.#...#.#.#.#.#...#.#..#.###..#.##.#.##.#
#...###...#.###..#.###.#..##..#.#..#.#.#.##.#.###...#...#.#...#.#.#..#..###.#.##.#..#.###..#..#..##
###.##...#.##.#.###.#...#...###...#....###.#.#...#.#.##..###.#..#....#....##..###..##.#.#.##..###.#
#..#.#...#.#..#..#..###.###.#.#.#..#.##.###.###..#..##.#..##.##..###.#.#..#..#.#.#..#.##..###.##.##
#.###.##...#...#...#..###...##.#.##.##..#...##.#.##...#.#...###.#.#.###..#..#.###..##.#..##.#.###.#
.#.###.#.#.###..#..##..#...#.#.#.#.###.#.#.#.##..#.#.##.#..###.#.##.#.#..#..##.#.#..#.#.##.#...##.#
##.#...###.##...#.###.#..#.#..#.##.#..#.##.###..##.#.....###.#..#...###.#.###.##.#...#.#.##.#...##.
.#.###.##.#.#..#.##...###.#.#.#.#.#..#.#.#..#.##..#.##..#.##.###..##..##..###...#...#.#.#.#..###.#.
.#..###.#.##..#...#.##.#.#...##.#.#.###..###...##.#...#..#.##..###..#.#.###.##.#.#.#..###.#..#...##
#..#.###.##..#.#.###.#.###..#.##.#...###...###.###..###...#..#.###...##..###.#.#..##.###.###..#.##.
.#..##.##..##.##.#..#...#.#.#...##.#.#.#..##.##.#.#.#.###.#.##...#...##..###.###.###.#..##..###.##.
..#..#...#.#..#.#.###..#..#.#.#.#...###.#..##.#.#.#.###...#.###..##.#.#.###..#.###.#.#.#.#..#.###.#
.#.###..#..#.###..##.##..##.#.##.#.#...##...###.#...#.#.#...#.##.#..#.#...#.###...#..#.##.##..##..#
.#.###..#..#..#.#..###.#..##.#.#..#.##.#..#.###..#...#.#.#.###.#.#.###.#.#..#.#.#..#.#.#.##..#...##
.#..###.##.#...#.#.#.#.##.##.#.#.###.#.##..##...#.#...##.#...#.#.##...###.###.##..#.###.#.#..##..##
##.##.#..#..##...#.###..#.#.#...#.###.##..#.##.###.##.#..###...#.###.###.#..#....###.##..###.##.##.
.#.#..#...#.#.#.#.##.#.#.#..#..##.##.###..##.#.###.#.#..##.#..#..###...###.#..#...#...###.##.###..#
..###.#..#...##...#.###.###.###.#.#.#..#.#..#.#.#..#.#.###.#......###..#..#.#..#...###..#.#.#..###.
#..###.#.#..#.#...##.#.##..##...###..#..#.###.##.#..###.#.#...###..#.#.#.#.#...##...##..##...##.#.#
##..#.###.#.#.###...##.##...##.#.#..#.##..##.#..###..#.#..###.#.#.#..###.#.#.##.##..#.#.###.###.#.#
..###..#.#.#.#..###..##...###.#...#.##.##.#..##.###..#..#.#..#.#.....###..#..##..#..##.##..###.###.
.#.###...###...###.#.###.###.###..##.#..#..#.##..###.#..#..###.#.#..#.....##..##..#...#..#.#.....#.
#...###..#.#..#..#.##.#.#.#.##...##.#.##.###...###.###.#.#..#.#.###.#.###..#.###..#.#.....#..##.E.#
#.###.#..#.#.#.##.#..###.#..#..###..##..###.#..##...###..##..#..#.#...#.#....#...#.#.#.#....#...#..
