###########
#S#...#.###
#.#.#...###
#.#.###.###
#.#...#.###
#.#.#.#.###
#.#.#.#.###
#.....#.###
#######E###
###########
