#########
.E......#
.......##
.#####.##
.#...#.##
...#...##
#####.###
......#.#
.......S#
