#################################################
#S#.............#.#.............................#
#.#.###########.#.#.###########################.#
#.#.............#.#.#...........................#
#.###############.#.#.#########################.#
#.................#.#.#.........................#
#.###############.#.#.#.#########################
#.#...............#.#.#.#.......................#
#.#.#############.#.#.#.#.#######################
#.#...............#.#.#.#.#.....................#
#.#.#############.#.#.#.#.#.#####################
#.#...............#.#.#.#.#.#...................#
#.#.###############.#.#.#.#.#.###################
#.#.................#.#.#.#.#.#.................#
#.###################.#.#.#.#.#.###############.#
#.....................#.#.#.#.#.#...............#
#.#####################.#.#.#.#.#.#############.#
#.......................#.#.#.#.#.#.............#
#.#######################.#.#.#.#.#.###########.#
#.........................#.#.#.#.#.#...........#
#.#########################.#.#.#.#.#.#########.#
#...........................#.#.#.#.#.#.........#
#.###########################.#.#.#.#.#.#######.#
#.............................#.#.#.#.#.#.......#
#.#############################.#.#.#.#.#.#####.#
#...............................#.#.#.#.#.#.....#
#.###############################.#.#.#.#.#.###.#
#.................................#.#.#.#.#.#...#
#.#################################.#.#.#.#.#.#.#
#...................................#.#.#.#.#.#.#
#.###################################.#.#.#.#.#.#
#.....................................#.#.#.#.#.#
#.#####################################.#.#.#.#.#
#.......................................#.#.#.#.#
#.#######################################.#.#.#.#
#.........................................#.#.#.#
#.###########################################.#.#
#.............................................#E#
#################################################
